2 0 8 9 0 0 0 0 7
0 0 5 4 0 7 0 0 2
0 9 0 0 0 0 0 0 6
0 0 0 0 0 5 8 4 0
0 3 0 0 0 0 0 6 0
0 5 2 6 0 0 0 0 0
5 0 0 0 0 0 0 7 0
7 0 0 5 0 8 9 0 0
6 0 0 0 0 9 5 0 4
