6 9 0 0 0 0 1 3 0
1 0 0 0 0 0 0 5 9
7 3 5 0 8 0 6 0 4
0 0 1 6 9 2 4 8 3
0 6 0 7 3 0 0 0 0
9 0 0 0 0 0 0 0 0
0 0 0 0 0 7 8 9 0
0 0 0 8 4 6 2 7 1
0 0 7 0 0 9 0 4 0
