0 3 1 6 2 0 0 4 8
0 0 0 0 5 1 0 2 7
8 7 0 0 4 9 0 0 6
9 0 8 4 7 0 0 6 3
0 0 7 0 8 6 0 5 0
4 0 5 0 3 2 0 0 0
0 0 3 0 0 0 0 0 5
0 5 6 2 9 8 7 0 0
0 0 4 0 0 0 1 8 2